107
8
6 0 0 0 0 0 0 0 0 0 0 0 0 0 0 0 0 0 0 0 0 0 0 0 0 0 0 0 0 0 0 0 0 0 0 0 0 0 0 0 0 0 0 5 6 6 6 6 6 6 6 6 6 6 6 6 6 6 6 6 6 6 6 6 6 6 6 6 6 6 6 6 6 6 6 8 0 0 0 0 0 0 0 0 0 0 0 0 0 0 5 6 6 6 6 6 6 6 6 6 6 6 6 6 6 6 6
6 0 0 0 0 0 0 0 0 0 0 0 0 0 0 0 0 0 0 0 0 0 0 0 0 0 0 0 0 0 0 0 0 0 0 0 0 0 0 0 0 0 0 0 0 6 6 6 6 6 6 6 6 6 6 6 6 6 6 6 0 0 0 0 0 0 0 0 0 0 0 6 6 6 6 8 0 0 0 0 0 0 0 0 0 0 0 0 0 0 0 0 6 6 6 6 6 0 0 0 0 0 0 0 0 0 6
6 0 0 0 0 0 0 0 0 0 0 0 0 0 0 0 0 0 0 0 0 0 0 0 0 0 0 0 0 0 0 0 0 0 0 0 0 0 0 0 0 0 0 0 0 0 0 0 0 6 6 6 6 6 6 6 6 6 6 6 8 0 0 0 0 0 0 0 0 0 0 0 0 6 6 8 0 0 0 0 0 0 0 0 0 0 0 0 0 0 0 0 0 6 6 6 6 8 0 0 0 0 0 0 0 5 6
6 0 0 0 0 0 0 0 0 0 0 0 0 0 0 0 0 0 0 0 0 0 0 0 0 0 0 0 0 0 0 0 0 0 0 0 0 0 0 5 9 6 0 0 0 0 0 0 0 0 0 0 6 6 6 6 6 6 6 0 0 0 0 0 0 0 0 0 0 0 0 0 0 0 0 0 0 0 0 0 0 0 0 0 5 5 6 0 0 0 0 0 0 0 6 6 6 8 0 0 0 0 0 0 0 5 6
6 0 0 0 0 0 0 0 0 0 0 0 0 5 5 5 6 0 0 0 0 0 0 0 0 0 0 0 0 0 0 0 0 5 6 0 0 0 0 0 0 0 0 0 0 0 0 0 0 0 0 0 0 0 0 0 0 0 0 0 0 5 5 5 5 6 0 0 0 0 0 0 0 0 0 0 0 0 0 5 9 6 0 0 5 6 8 0 0 0 0 0 0 0 0 6 6 8 0 0 0 0 0 0 0 5 6
6 0 0 0 0 0 0 0 0 0 5 5 5 5 6 6 8 0 0 0 0 0 0 0 0 0 0 0 0 0 0 0 0 0 0 0 0 0 0 0 0 0 0 5 5 5 5 5 6 0 0 0 0 0 0 0 0 0 0 0 0 5 6 6 6 8 0 0 0 0 0 0 0 0 0 0 0 0 0 0 0 0 0 0 5 6 8 0 0 0 0 0 0 0 0 0 0 0 0 0 0 0 0 0 0 5 6
6 0 0 0 0 0 0 0 0 0 6 6 6 6 6 6 8 0 0 0 5 5 5 5 5 6 0 0 0 5 5 5 6 0 0 5 5 5 6 0 0 0 0 5 6 6 6 6 8 0 0 5 5 6 0 0 5 5 6 0 5 5 6 6 6 8 0 0 0 0 0 0 0 0 0 0 0 0 0 0 0 0 0 5 5 9 5 6 0 0 0 0 0 0 0 0 0 0 0 0 0 0 0 0 0 5 6
6 5 5 5 5 5 5 5 5 5 6 6 6 6 6 6 8 0 0 0 5 6 6 6 6 5 5 5 5 5 6 9 5 5 5 5 6 6 8 0 0 0 0 5 6 6 6 9 5 5 5 5 5 5 5 5 5 5 5 5 5 6 6 6 6 8 0 0 0 0 0 5 5 5 5 5 5 5 5 5 5 5 5 5 6 6 9 5 5 5 5 5 5 5 5 5 5 5 5 5 5 5 5 5 5 5 6
